XXXXMXXXXXXXXXX
XXXX@@@@@@@@@@X
XXXXXXXXXXXXX@X
XXXXX@@@@@@@@@X
XXXXX@XXXXXXXXX
XXXXX@@@@XXXXXX
XXXXXXXX@XXXXXX
XXX@@@@@@XXXXXX
XXXGXXXX@@@@@XX
XXXXXXXXXXXX@XX
XX@@@@@@@@@X@XX
XX@XXXXXXX@X@XX
XX@@@@@XXX@@@XX
XXXXXX@XXXXXXXX
XXXXXX@XXXXXXXX
