MXXXXXXXXXXXXXX
@@@@@@@@@@@@@@X
XXXXXXXX@XXXX@X
XXXXX@@@@@@@@@X
XXXXX@XXXXXXXXX
XXXXX@@@@@@@@XX
XXXXXXXX@XXXXXX
XXX@@@@@@XXXXXX
XXXXXXXX@@@@@XX
XXXXXXXXXXXX@XX
XX@@@@@@@@@X@XX
XX@XXXXXXX@X@XX
XX@@@@@XXX@@@XX
XXXXXX@XXXXXXXX
XXXXXX@@@@@@@@G

